XXXXXXXXXXXXXXXXXXXXXXXX
X----------------------X
XXXXXXXXXXXXXXXXXXXXXX-X
X--------------------X-X
X-XXXXXXXXXXXXXXXXXX-X-X
X-X----------------X-X-X
X-X-XXXXXXXXXXXXXX-X-X-X
X-X-X------------X-X-X-X
X-X-X-XXXXXXXXXX-X-X-X-X
X-X-X-X--------X-X-X-X-X
X-X-X-X-XXXXXX-X-X-X-X-X
X-X-X-X-X----X-X-X-X-X-X
X-X-X-X-X-XO-X-X-X-X-X-X
X-X-X-X-X-XXXX-X-X-X-X-X
X-X-X-X-X------X-X-X-X-X
X-X-X-X-XXXXXXXX-X-X-X-X
X-X-X-X----------X-X-X-X
X-X-X-XXXXXXXXXXXX-X-X-X
X-X-X--------------X-X-X
X-X-XXXXXXXXXXXXXXXX-X-X
X-X------------------X-X
X-XXXXXXXXXXXXXXXXXXXX-X
X----------------------X
XXXXXXXXXXXXXXXXXXXXXXXX