XXXXXXXXXXXXX
X-----------X
XXX---------X
X-----------X
XXXXXXXXXXXXX